
















     SO textures/file1.xpm  

                                        WE textures/file2.xpm              

                EA textures/file3.xpm




   NO textures/file4.xpm


F 20,0,255
C 200,200,22


1111111111111
100000N000001
1111111111011
11111111111
